00001010001000000000
11101010000000000000
00001011100000000000
01111000100000000000
00001010100000000000
00101010100000000000
00101010100000000000
00100010100000000000
01111000100000000000
00001010100000000000
00101011100000011100
00101010000000000100
00100010000001110111
01111010111011000111
00001010100010000000
00101010100010000000
00101010111110111110
00100010100000100000
00111110100000101111
00000000100000100000
